"filename", "language", "JavaScript", "SCSS", "JavaScript React", "JSON", "CSS", "comment", "blank", "total"
"/Users/mac/Workspaces/Code/foa/frontend/src/App.js", "JavaScript", 246, 0, 0, 0, 0, 29, 27, 302
"/Users/mac/Workspaces/Code/foa/frontend/src/AppRenderer.js", "JavaScript", 19, 0, 0, 0, 0, 6, 4, 29
"/Users/mac/Workspaces/Code/foa/frontend/src/assets/css/sass/_base.style.scss", "SCSS", 0, 7194, 0, 0, 0, 114, 1470, 8778
"/Users/mac/Workspaces/Code/foa/frontend/src/assets/css/sass/_custom.style.scss", "SCSS", 0, 99, 0, 0, 0, 7, 23, 129
"/Users/mac/Workspaces/Code/foa/frontend/src/assets/css/sass/_mixins.scss", "SCSS", 0, 78, 0, 0, 0, 24, 17, 119
"/Users/mac/Workspaces/Code/foa/frontend/src/assets/css/sass/themes/base.dark.blue.scss", "SCSS", 0, 30, 0, 0, 0, 0, 9, 39
"/Users/mac/Workspaces/Code/foa/frontend/src/assets/css/sass/themes/base.dark.green.scss", "SCSS", 0, 30, 0, 0, 0, 0, 9, 39
"/Users/mac/Workspaces/Code/foa/frontend/src/assets/css/sass/themes/base.dark.orange.scss", "SCSS", 0, 30, 0, 0, 0, 0, 9, 39
"/Users/mac/Workspaces/Code/foa/frontend/src/assets/css/sass/themes/base.dark.purple.scss", "SCSS", 0, 30, 0, 0, 0, 0, 9, 39
"/Users/mac/Workspaces/Code/foa/frontend/src/assets/css/sass/themes/base.dark.red.scss", "SCSS", 0, 30, 0, 0, 0, 0, 9, 39
"/Users/mac/Workspaces/Code/foa/frontend/src/assets/css/sass/themes/base.light.blue.scss", "SCSS", 0, 30, 0, 0, 0, 0, 10, 40
"/Users/mac/Workspaces/Code/foa/frontend/src/assets/css/sass/themes/base.light.green.scss", "SCSS", 0, 30, 0, 0, 0, 0, 10, 40
"/Users/mac/Workspaces/Code/foa/frontend/src/assets/css/sass/themes/base.light.orange.scss", "SCSS", 0, 31, 0, 0, 0, 0, 10, 41
"/Users/mac/Workspaces/Code/foa/frontend/src/assets/css/sass/themes/base.light.purple.scss", "SCSS", 0, 30, 0, 0, 0, 0, 10, 40
"/Users/mac/Workspaces/Code/foa/frontend/src/assets/css/sass/themes/base.light.red.scss", "SCSS", 0, 30, 0, 0, 0, 0, 10, 40
"/Users/mac/Workspaces/Code/foa/frontend/src/assets/css/vendor/bootstrap.min.css", "CSS", 0, 0, 0, 0, 1, 6, 0, 7
"/Users/mac/Workspaces/Code/foa/frontend/src/assets/css/vendor/bootstrap.rtl.only.min.css", "CSS", 0, 0, 0, 0, 1356, 0, 72, 1428
"/Users/mac/Workspaces/Code/foa/frontend/src/components/CalendarToolbar.js", "JavaScript", 45, 0, 0, 0, 0, 0, 6, 51
"/Users/mac/Workspaces/Code/foa/frontend/src/components/DatatablePagination.js", "JavaScript", 159, 0, 0, 0, 0, 0, 16, 175
"/Users/mac/Workspaces/Code/foa/frontend/src/components/StateButton.js", "JavaScript", 91, 0, 0, 0, 0, 0, 4, 95
"/Users/mac/Workspaces/Code/foa/frontend/src/components/applications/ChatHeading.js", "JavaScript", 30, 0, 0, 0, 0, 0, 3, 33
"/Users/mac/Workspaces/Code/foa/frontend/src/components/applications/MessageCard.js", "JavaScript", 40, 0, 0, 0, 0, 0, 4, 44
"/Users/mac/Workspaces/Code/foa/frontend/src/components/applications/SaySomething.js", "JavaScript", 38, 0, 0, 0, 0, 0, 3, 41
"/Users/mac/Workspaces/Code/foa/frontend/src/components/applications/SurveyDetailCard.js", "JavaScript", 35, 0, 0, 0, 0, 0, 6, 41
"/Users/mac/Workspaces/Code/foa/frontend/src/components/applications/SurveyListItem.js", "JavaScript", 51, 0, 0, 0, 0, 0, 4, 55
"/Users/mac/Workspaces/Code/foa/frontend/src/components/applications/SurveyQuota.js", "JavaScript", 51, 0, 0, 0, 0, 0, 4, 55
"/Users/mac/Workspaces/Code/foa/frontend/src/components/applications/TodoListItem.js", "JavaScript", 55, 0, 0, 0, 0, 0, 4, 59
"/Users/mac/Workspaces/Code/foa/frontend/src/components/cards/GradientCard.js", "JavaScript", 12, 0, 0, 0, 0, 0, 2, 14
"/Users/mac/Workspaces/Code/foa/frontend/src/components/cards/GradientWithRadialProgressCard.js", "JavaScript", 34, 0, 0, 0, 0, 0, 2, 36
"/Users/mac/Workspaces/Code/foa/frontend/src/components/cards/IconCard.js", "JavaScript", 19, 0, 0, 0, 0, 0, 2, 21
"/Users/mac/Workspaces/Code/foa/frontend/src/components/cards/Post.js", "JavaScript", 96, 0, 0, 0, 0, 0, 10, 106
"/Users/mac/Workspaces/Code/foa/frontend/src/components/cards/PriceCard.js", "JavaScript", 43, 0, 0, 0, 0, 0, 12, 55
"/Users/mac/Workspaces/Code/foa/frontend/src/components/cards/RadialProgressCard.js", "JavaScript", 31, 0, 0, 0, 0, 0, 2, 33
"/Users/mac/Workspaces/Code/foa/frontend/src/components/cards/ThumbnailImage.js", "JavaScript", 18, 0, 0, 0, 0, 0, 2, 20
"/Users/mac/Workspaces/Code/foa/frontend/src/components/cards/ThumbnailLetters.js", "JavaScript", 31, 0, 0, 0, 0, 0, 4, 35
"/Users/mac/Workspaces/Code/foa/frontend/src/components/cards/UserCardBasic.js", "JavaScript", 38, 0, 0, 0, 0, 0, 3, 41
"/Users/mac/Workspaces/Code/foa/frontend/src/components/carousel/GlideComponent.js", "JavaScript", 105, 0, 0, 0, 0, 0, 11, 116
"/Users/mac/Workspaces/Code/foa/frontend/src/components/carousel/GlideComponentThumbs.js", "JavaScript", 196, 0, 0, 0, 0, 0, 17, 213
"/Users/mac/Workspaces/Code/foa/frontend/src/components/charts/Area.js", "JavaScript", 41, 0, 0, 0, 0, 0, 4, 45
"/Users/mac/Workspaces/Code/foa/frontend/src/components/charts/Bar.js", "JavaScript", 41, 0, 0, 0, 0, 0, 5, 46
"/Users/mac/Workspaces/Code/foa/frontend/src/components/charts/Doughnut.js", "JavaScript", 40, 0, 0, 0, 0, 0, 4, 44
"/Users/mac/Workspaces/Code/foa/frontend/src/components/charts/Line.js", "JavaScript", 39, 0, 0, 0, 0, 0, 4, 43
"/Users/mac/Workspaces/Code/foa/frontend/src/components/charts/Pie.js", "JavaScript", 38, 0, 0, 0, 0, 0, 4, 42
"/Users/mac/Workspaces/Code/foa/frontend/src/components/charts/PolarArea.js", "JavaScript", 38, 0, 0, 0, 0, 0, 4, 42
"/Users/mac/Workspaces/Code/foa/frontend/src/components/charts/Radar.js", "JavaScript", 38, 0, 0, 0, 0, 0, 4, 42
"/Users/mac/Workspaces/Code/foa/frontend/src/components/charts/Scatter.js", "JavaScript", 38, 0, 0, 0, 0, 0, 4, 42
"/Users/mac/Workspaces/Code/foa/frontend/src/components/charts/SmallLine.js", "JavaScript", 94, 0, 0, 0, 0, 0, 9, 103
"/Users/mac/Workspaces/Code/foa/frontend/src/components/charts/config.js", "JavaScript", 268, 0, 0, 0, 0, 0, 9, 277
"/Users/mac/Workspaces/Code/foa/frontend/src/components/charts/index.js", "JavaScript", 20, 0, 0, 0, 0, 0, 2, 22
"/Users/mac/Workspaces/Code/foa/frontend/src/components/charts/util.js", "JavaScript", 64, 0, 0, 0, 0, 0, 14, 78
"/Users/mac/Workspaces/Code/foa/frontend/src/components/common/ApplicationMenu.js", "JavaScript", 58, 0, 0, 0, 0, 0, 10, 68
"/Users/mac/Workspaces/Code/foa/frontend/src/components/common/ColorSwitcher.js", "JavaScript", 139, 0, 0, 0, 0, 2, 10, 151
"/Users/mac/Workspaces/Code/foa/frontend/src/components/common/CustomBootstrap.js", "JavaScript", 9, 0, 0, 0, 0, 0, 0, 9
"/Users/mac/Workspaces/Code/foa/frontend/src/components/common/CustomSelectInput.js", "JavaScript", 9, 0, 0, 0, 0, 0, 3, 12
"/Users/mac/Workspaces/Code/foa/frontend/src/components/common/DatePicker/DatePicker.js", "JavaScript", 32, 0, 0, 0, 0, 4, 5, 41
"/Users/mac/Workspaces/Code/foa/frontend/src/components/common/DatePicker/DatePicker.scss", "SCSS", 0, 5, 0, 0, 0, 0, 1, 6
"/Users/mac/Workspaces/Code/foa/frontend/src/components/common/DatePicker/index.js", "JavaScript", 2, 0, 0, 0, 0, 0, 2, 4
"/Users/mac/Workspaces/Code/foa/frontend/src/components/common/PopoverItem.js", "JavaScript", 38, 0, 0, 0, 0, 0, 4, 42
"/Users/mac/Workspaces/Code/foa/frontend/src/components/common/Rating.js", "JavaScript", 36, 0, 0, 0, 0, 1, 6, 43
"/Users/mac/Workspaces/Code/foa/frontend/src/components/common/ReactAutoSuggest.js", "JavaScript", 73, 0, 0, 0, 0, 0, 12, 85
"/Users/mac/Workspaces/Code/foa/frontend/src/components/common/RecentPost.js", "JavaScript", 22, 0, 0, 0, 0, 0, 2, 24
"/Users/mac/Workspaces/Code/foa/frontend/src/components/common/SliderTooltips.js", "JavaScript", 76, 0, 0, 0, 0, 1, 7, 84
"/Users/mac/Workspaces/Code/foa/frontend/src/components/common/TooltipItem.js", "JavaScript", 37, 0, 0, 0, 0, 0, 3, 40
"/Users/mac/Workspaces/Code/foa/frontend/src/components/common/UploadImage/index.js", "JavaScript", 2, 0, 0, 0, 0, 0, 2, 4
"/Users/mac/Workspaces/Code/foa/frontend/src/components/common/UploadImage/upload.js", "JavaScript", 109, 0, 0, 0, 0, 3, 9, 121
"/Users/mac/Workspaces/Code/foa/frontend/src/components/common/UploadImage/upload.scss", "SCSS", 0, 45, 0, 0, 0, 10, 9, 64
"/Users/mac/Workspaces/Code/foa/frontend/src/components/common/UserFollow.js", "JavaScript", 23, 0, 0, 0, 0, 0, 3, 26
"/Users/mac/Workspaces/Code/foa/frontend/src/components/common/VideoPlayer.js", "JavaScript", 22, 0, 0, 0, 0, 0, 2, 24
"/Users/mac/Workspaces/Code/foa/frontend/src/components/common/react-notifications/Notification.js", "JavaScript", 64, 0, 0, 0, 0, 0, 9, 73
"/Users/mac/Workspaces/Code/foa/frontend/src/components/common/react-notifications/NotificationContainer.js", "JavaScript", 45, 0, 0, 0, 0, 0, 10, 55
"/Users/mac/Workspaces/Code/foa/frontend/src/components/common/react-notifications/NotificationManager.js", "JavaScript", 120, 0, 0, 0, 0, 0, 17, 137
"/Users/mac/Workspaces/Code/foa/frontend/src/components/common/react-notifications/Notifications.js", "JavaScript", 59, 0, 0, 0, 0, 0, 6, 65
"/Users/mac/Workspaces/Code/foa/frontend/src/components/common/react-notifications/index.js", "JavaScript", 5, 0, 0, 0, 0, 0, 2, 7
"/Users/mac/Workspaces/Code/foa/frontend/src/components/forms/ProfileForm.js", "JavaScript", 226, 0, 0, 0, 0, 2, 21, 249
"/Users/mac/Workspaces/Code/foa/frontend/src/components/map/Map/Mapbox.jsx", "JavaScript React", 0, 0, 49, 0, 0, 2, 9, 60
"/Users/mac/Workspaces/Code/foa/frontend/src/components/map/Map/Mapbox.scss", "SCSS", 0, 24, 0, 0, 0, 1, 4, 29
"/Users/mac/Workspaces/Code/foa/frontend/src/components/map/Map/index.jsx", "JavaScript React", 0, 0, 2, 0, 0, 0, 2, 4
"/Users/mac/Workspaces/Code/foa/frontend/src/components/pages/CommentWithLikes.js", "JavaScript", 48, 0, 0, 0, 0, 0, 5, 53
"/Users/mac/Workspaces/Code/foa/frontend/src/components/pages/QuestionAnswer.js", "JavaScript", 37, 0, 0, 0, 0, 0, 4, 41
"/Users/mac/Workspaces/Code/foa/frontend/src/components/pages/SingleLightbox.js", "JavaScript", 33, 0, 0, 0, 0, 0, 7, 40
"/Users/mac/Workspaces/Code/foa/frontend/src/components/svg/DataListIcon.js", "JavaScript", 20, 0, 0, 0, 0, 0, 3, 23
"/Users/mac/Workspaces/Code/foa/frontend/src/components/svg/ImageListIcon.js", "JavaScript", 12, 0, 0, 0, 0, 0, 3, 15
"/Users/mac/Workspaces/Code/foa/frontend/src/components/svg/MenuIcon.js", "JavaScript", 18, 0, 0, 0, 0, 0, 2, 20
"/Users/mac/Workspaces/Code/foa/frontend/src/components/svg/MobileMenuIcon.js", "JavaScript", 11, 0, 0, 0, 0, 0, 3, 14
"/Users/mac/Workspaces/Code/foa/frontend/src/components/svg/ThumbListIcon.js", "JavaScript", 32, 0, 0, 0, 0, 0, 3, 35
"/Users/mac/Workspaces/Code/foa/frontend/src/components/svg/index.js", "JavaScript", 6, 0, 0, 0, 0, 0, 2, 8
"/Users/mac/Workspaces/Code/foa/frontend/src/components/wizard/BottomNavigation.js", "JavaScript", 23, 0, 0, 0, 0, 0, 3, 26
"/Users/mac/Workspaces/Code/foa/frontend/src/components/wizard/TopNavigation.js", "JavaScript", 48, 0, 0, 0, 0, 0, 4, 52
"/Users/mac/Workspaces/Code/foa/frontend/src/constants/config.js", "JavaScript", 12, 0, 0, 0, 0, 5, 3, 20
"/Users/mac/Workspaces/Code/foa/frontend/src/constants/constants.js", "JavaScript", 59, 0, 0, 0, 0, 0, 5, 64
"/Users/mac/Workspaces/Code/foa/frontend/src/constants/defaultValues.js", "JavaScript", 26, 0, 0, 0, 0, 16, 5, 47
"/Users/mac/Workspaces/Code/foa/frontend/src/constants/index.js", "JavaScript", 4, 0, 0, 0, 0, 0, 1, 5
"/Users/mac/Workspaces/Code/foa/frontend/src/constants/menu.js", "JavaScript", 77, 0, 0, 0, 0, 82, 3, 162
"/Users/mac/Workspaces/Code/foa/frontend/src/containers/dashboards/ConversionRatesChartCard.js", "JavaScript", 48, 0, 0, 0, 0, 1, 7, 56
"/Users/mac/Workspaces/Code/foa/frontend/src/containers/dashboards/OrderAreaChartCard.js", "JavaScript", 98, 0, 0, 0, 0, 46, 16, 160
"/Users/mac/Workspaces/Code/foa/frontend/src/containers/dashboards/OrderAreaChartCard.scss", "SCSS", 0, 39, 0, 0, 0, 1, 9, 49
"/Users/mac/Workspaces/Code/foa/frontend/src/containers/dashboards/OrderByMonthChartCard.js", "JavaScript", 190, 0, 0, 0, 0, 5, 21, 216
"/Users/mac/Workspaces/Code/foa/frontend/src/containers/dashboards/OrderByMonthChartCard.scss", "SCSS", 0, 37, 0, 0, 0, 0, 9, 46
"/Users/mac/Workspaces/Code/foa/frontend/src/containers/dashboards/OrderRevenueChartCard.js", "JavaScript", 263, 0, 0, 0, 0, 38, 25, 326
"/Users/mac/Workspaces/Code/foa/frontend/src/containers/dashboards/OrderRevenueChartCard.scss", "SCSS", 0, 37, 0, 0, 0, 0, 9, 46
"/Users/mac/Workspaces/Code/foa/frontend/src/containers/dashboards/OrderRevenuePieChartCard.js", "JavaScript", 159, 0, 0, 0, 0, 20, 18, 197
"/Users/mac/Workspaces/Code/foa/frontend/src/containers/dashboards/OrderRevenuePieChartCard.scss", "SCSS", 0, 38, 0, 0, 0, 1, 9, 48
"/Users/mac/Workspaces/Code/foa/frontend/src/containers/dashboards/OrderStatusChartCard.js", "JavaScript", 179, 0, 0, 0, 0, 21, 21, 221
"/Users/mac/Workspaces/Code/foa/frontend/src/containers/dashboards/OrderStatusChartCard.scss", "SCSS", 0, 39, 0, 0, 0, 1, 9, 49
"/Users/mac/Workspaces/Code/foa/frontend/src/containers/dashboards/OrderStockRadarChart.js", "JavaScript", 20, 0, 0, 0, 0, 0, 5, 25
"/Users/mac/Workspaces/Code/foa/frontend/src/containers/dashboards/ProductCategoriesDoughnut.js", "JavaScript", 20, 0, 0, 0, 0, 0, 5, 25
"/Users/mac/Workspaces/Code/foa/frontend/src/containers/dashboards/ProductCategoriesPolarArea.js", "JavaScript", 20, 0, 0, 0, 0, 0, 5, 25
"/Users/mac/Workspaces/Code/foa/frontend/src/containers/dashboards/ProfileStatuses.js", "JavaScript", 30, 0, 0, 0, 0, 0, 4, 34
"/Users/mac/Workspaces/Code/foa/frontend/src/containers/dashboards/RevenueInsightChartCard.js", "JavaScript", 179, 0, 0, 0, 0, 23, 21, 223
"/Users/mac/Workspaces/Code/foa/frontend/src/containers/dashboards/RevenueInsightChartCard.scss", "SCSS", 0, 39, 0, 0, 0, 0, 9, 48
"/Users/mac/Workspaces/Code/foa/frontend/src/containers/dashboards/SalesChartCard.js", "JavaScript", 48, 0, 0, 0, 0, 0, 6, 54
"/Users/mac/Workspaces/Code/foa/frontend/src/containers/dashboards/SmallLineCharts.js", "JavaScript", 45, 0, 0, 0, 0, 0, 5, 50
"/Users/mac/Workspaces/Code/foa/frontend/src/containers/dashboards/SortableStaticticsRow.js", "JavaScript", 39, 0, 0, 0, 0, 0, 4, 43
"/Users/mac/Workspaces/Code/foa/frontend/src/containers/dashboards/WebsiteVisitsChartCard.js", "JavaScript", 51, 0, 0, 0, 0, 0, 6, 57
"/Users/mac/Workspaces/Code/foa/frontend/src/containers/form-validations/AvailityBasic.js", "JavaScript", 86, 0, 0, 0, 0, 1, 10, 97
"/Users/mac/Workspaces/Code/foa/frontend/src/containers/form-validations/AvailityCustom.js", "JavaScript", 153, 0, 0, 0, 0, 1, 14, 168
"/Users/mac/Workspaces/Code/foa/frontend/src/containers/form-validations/AvailityDefaultValues.js", "JavaScript", 84, 0, 0, 0, 0, 1, 13, 98
"/Users/mac/Workspaces/Code/foa/frontend/src/containers/form-validations/FormikBasicFieldLevel.js", "JavaScript", 87, 0, 0, 0, 0, 0, 10, 97
"/Users/mac/Workspaces/Code/foa/frontend/src/containers/form-validations/FormikBasicFormLevel.js", "JavaScript", 76, 0, 0, 0, 0, 0, 13, 89
"/Users/mac/Workspaces/Code/foa/frontend/src/containers/form-validations/FormikCustomComponents.js", "JavaScript", 323, 0, 0, 0, 0, 0, 17, 340
"/Users/mac/Workspaces/Code/foa/frontend/src/containers/form-validations/FormikCustomWithTopLabels.js", "JavaScript", 300, 0, 0, 0, 0, 0, 19, 319
"/Users/mac/Workspaces/Code/foa/frontend/src/containers/form-validations/FormikFields.js", "JavaScript", 282, 0, 0, 0, 0, 0, 21, 303
"/Users/mac/Workspaces/Code/foa/frontend/src/containers/form-validations/FormikValidationSchema.js", "JavaScript", 111, 0, 0, 0, 0, 0, 13, 124
"/Users/mac/Workspaces/Code/foa/frontend/src/containers/form-validations/TooltipLocations.js", "JavaScript", 152, 0, 0, 0, 0, 0, 22, 174
"/Users/mac/Workspaces/Code/foa/frontend/src/containers/navs/Breadcrumb.js", "JavaScript", 53, 0, 0, 0, 0, 0, 6, 59
"/Users/mac/Workspaces/Code/foa/frontend/src/containers/navs/Sidebar.js", "JavaScript", 524, 0, 0, 0, 0, 127, 34, 685
"/Users/mac/Workspaces/Code/foa/frontend/src/containers/navs/Topnav.DarkSwitch.js", "JavaScript", 66, 0, 0, 0, 0, 0, 9, 75
"/Users/mac/Workspaces/Code/foa/frontend/src/containers/navs/Topnav.EasyAccess.js", "JavaScript", 46, 0, 0, 0, 0, 0, 4, 50
"/Users/mac/Workspaces/Code/foa/frontend/src/containers/navs/Topnav.Notifications.js", "JavaScript", 52, 0, 0, 0, 0, 0, 5, 57
"/Users/mac/Workspaces/Code/foa/frontend/src/containers/navs/Topnav.js", "JavaScript", 350, 0, 0, 0, 0, 51, 43, 444
"/Users/mac/Workspaces/Code/foa/frontend/src/containers/pages/AddNewModal.js", "JavaScript", 62, 0, 0, 0, 0, 28, 3, 93
"/Users/mac/Workspaces/Code/foa/frontend/src/containers/pages/ContextMenuContainer.js", "JavaScript", 21, 0, 0, 0, 0, 0, 3, 24
"/Users/mac/Workspaces/Code/foa/frontend/src/containers/pages/DataListView.js", "JavaScript", 123, 0, 0, 0, 0, 5, 10, 138
"/Users/mac/Workspaces/Code/foa/frontend/src/containers/pages/FeatureComparison.js", "JavaScript", 321, 0, 0, 0, 0, 0, 23, 344
"/Users/mac/Workspaces/Code/foa/frontend/src/containers/pages/GalleryDetail.js", "JavaScript", 73, 0, 0, 0, 0, 0, 8, 81
"/Users/mac/Workspaces/Code/foa/frontend/src/containers/pages/GalleryProfile.js", "JavaScript", 121, 0, 0, 0, 0, 0, 13, 134
"/Users/mac/Workspaces/Code/foa/frontend/src/containers/pages/ImageListView.js", "JavaScript", 69, 0, 0, 0, 0, 1, 3, 73
"/Users/mac/Workspaces/Code/foa/frontend/src/containers/pages/ListPageHeading.js", "JavaScript", 261, 0, 0, 0, 0, 0, 14, 275
"/Users/mac/Workspaces/Code/foa/frontend/src/containers/pages/ListPageHeading.scss", "SCSS", 0, 4, 0, 0, 0, 2, 1, 7
"/Users/mac/Workspaces/Code/foa/frontend/src/containers/pages/Orders.js", "JavaScript", 40, 0, 0, 0, 0, 0, 5, 45
"/Users/mac/Workspaces/Code/foa/frontend/src/containers/pages/Pagination.js", "JavaScript", 99, 0, 0, 0, 0, 0, 6, 105
"/Users/mac/Workspaces/Code/foa/frontend/src/containers/pages/ThumbListView.js", "JavaScript", 75, 0, 0, 0, 0, 1, 4, 80
"/Users/mac/Workspaces/Code/foa/frontend/src/data/charts.js", "JavaScript", 267, 0, 0, 0, 0, 3, 14, 284
"/Users/mac/Workspaces/Code/foa/frontend/src/data/notifications.js", "JavaScript", 27, 0, 0, 0, 0, 1, 1, 29
"/Users/mac/Workspaces/Code/foa/frontend/src/data/profileStatuses.js", "JavaScript", 28, 0, 0, 0, 0, 6, 1, 35
"/Users/mac/Workspaces/Code/foa/frontend/src/helpers/Firebase.js", "JavaScript", 10, 0, 0, 0, 0, 0, 6, 16
"/Users/mac/Workspaces/Code/foa/frontend/src/helpers/IntlMessages.js", "JavaScript", 6, 0, 0, 0, 0, 0, 3, 9
"/Users/mac/Workspaces/Code/foa/frontend/src/helpers/ThemeColors.js", "JavaScript", 20, 0, 0, 0, 0, 0, 0, 20
"/Users/mac/Workspaces/Code/foa/frontend/src/helpers/Utils.js", "JavaScript", 138, 0, 0, 0, 0, 45, 24, 207
"/Users/mac/Workspaces/Code/foa/frontend/src/index.js", "JavaScript", 24, 0, 0, 0, 0, 0, 4, 28
"/Users/mac/Workspaces/Code/foa/frontend/src/lang/entries/en-US-rtl.js", "JavaScript", 10, 0, 0, 0, 0, 0, 1, 11
"/Users/mac/Workspaces/Code/foa/frontend/src/lang/entries/en-US.js", "JavaScript", 10, 0, 0, 0, 0, 0, 1, 11
"/Users/mac/Workspaces/Code/foa/frontend/src/lang/entries/es-ES.js", "JavaScript", 10, 0, 0, 0, 0, 0, 1, 11
"/Users/mac/Workspaces/Code/foa/frontend/src/lang/index.js", "JavaScript", 13, 0, 0, 0, 0, 0, 3, 16
"/Users/mac/Workspaces/Code/foa/frontend/src/lang/locales/en_US.js", "JavaScript", 179, 0, 0, 0, 0, 15, 18, 212
"/Users/mac/Workspaces/Code/foa/frontend/src/lang/locales/es_ES.js", "JavaScript", 32, 0, 0, 0, 0, 13, 4, 49
"/Users/mac/Workspaces/Code/foa/frontend/src/layout/AppLayout.js", "JavaScript", 30, 0, 0, 0, 0, 0, 3, 33
"/Users/mac/Workspaces/Code/foa/frontend/src/layout/MerchantLayout.js", "JavaScript", 20, 0, 0, 0, 0, 0, 4, 24
"/Users/mac/Workspaces/Code/foa/frontend/src/layout/RestaurantLayout.js", "JavaScript", 20, 0, 0, 0, 0, 0, 4, 24
"/Users/mac/Workspaces/Code/foa/frontend/src/redux/actions.js", "JavaScript", 91, 0, 0, 0, 0, 20, 21, 132
"/Users/mac/Workspaces/Code/foa/frontend/src/redux/auth/actions.js", "JavaScript", 71, 0, 0, 0, 0, 4, 6, 81
"/Users/mac/Workspaces/Code/foa/frontend/src/redux/auth/reducer.js", "JavaScript", 88, 0, 0, 0, 0, 2, 3, 93
"/Users/mac/Workspaces/Code/foa/frontend/src/redux/auth/saga.js", "JavaScript", 141, 0, 0, 0, 0, 51, 23, 215
"/Users/mac/Workspaces/Code/foa/frontend/src/redux/menu/actions.js", "JavaScript", 251, 0, 0, 0, 0, 0, 40, 291
"/Users/mac/Workspaces/Code/foa/frontend/src/redux/menu/reducer.js", "JavaScript", 357, 0, 0, 0, 0, 30, 35, 422
"/Users/mac/Workspaces/Code/foa/frontend/src/redux/menu/saga.js", "JavaScript", 628, 0, 0, 0, 0, 12, 32, 672
"/Users/mac/Workspaces/Code/foa/frontend/src/redux/menu2/actions.js", "JavaScript", 113, 0, 0, 0, 0, 0, 9, 122
"/Users/mac/Workspaces/Code/foa/frontend/src/redux/menu2/reducer.js", "JavaScript", 42, 0, 0, 0, 0, 0, 12, 54
"/Users/mac/Workspaces/Code/foa/frontend/src/redux/merchant/actions.js", "JavaScript", 17, 0, 0, 0, 0, 0, 4, 21
"/Users/mac/Workspaces/Code/foa/frontend/src/redux/merchant/reducer.js", "JavaScript", 33, 0, 0, 0, 0, 0, 3, 36
"/Users/mac/Workspaces/Code/foa/frontend/src/redux/merchant/saga.js", "JavaScript", 46, 0, 0, 0, 0, 4, 5, 55
"/Users/mac/Workspaces/Code/foa/frontend/src/redux/newOrder/actions.js", "JavaScript", 5, 0, 0, 0, 0, 0, 2, 7
"/Users/mac/Workspaces/Code/foa/frontend/src/redux/newOrder/reducer.js", "JavaScript", 22, 0, 0, 0, 0, 33, 5, 60
"/Users/mac/Workspaces/Code/foa/frontend/src/redux/newOrder/saga.js", "JavaScript", 43, 0, 0, 0, 0, 1, 5, 49
"/Users/mac/Workspaces/Code/foa/frontend/src/redux/reducers.js", "JavaScript", 20, 0, 0, 0, 0, 0, 3, 23
"/Users/mac/Workspaces/Code/foa/frontend/src/redux/restaurant/actions.js", "JavaScript", 37, 0, 0, 0, 0, 0, 8, 45
"/Users/mac/Workspaces/Code/foa/frontend/src/redux/restaurant/reducer.js", "JavaScript", 41, 0, 0, 0, 0, 20, 4, 65
"/Users/mac/Workspaces/Code/foa/frontend/src/redux/restaurant/saga.js", "JavaScript", 100, 0, 0, 0, 0, 6, 8, 114
"/Users/mac/Workspaces/Code/foa/frontend/src/redux/sagas.js", "JavaScript", 15, 0, 0, 0, 0, 0, 2, 17
"/Users/mac/Workspaces/Code/foa/frontend/src/redux/settings/actions.js", "JavaScript", 12, 0, 0, 0, 0, 0, 4, 16
"/Users/mac/Workspaces/Code/foa/frontend/src/redux/settings/reducer.js", "JavaScript", 14, 0, 0, 0, 0, 0, 5, 19
"/Users/mac/Workspaces/Code/foa/frontend/src/redux/staff/actions.js", "JavaScript", 52, 0, 0, 0, 0, 0, 9, 61
"/Users/mac/Workspaces/Code/foa/frontend/src/redux/staff/reducer.js", "JavaScript", 53, 0, 0, 0, 0, 0, 4, 57
"/Users/mac/Workspaces/Code/foa/frontend/src/redux/staff/saga.js", "JavaScript", 43, 0, 0, 0, 0, 1, 5, 49
"/Users/mac/Workspaces/Code/foa/frontend/src/redux/store.js", "JavaScript", 33, 0, 0, 0, 0, 9, 12, 54
"/Users/mac/Workspaces/Code/foa/frontend/src/redux/utils/index.js", "JavaScript", 8, 0, 0, 0, 0, 0, 1, 9
"/Users/mac/Workspaces/Code/foa/frontend/src/serviceWorker.js", "JavaScript", 92, 0, 0, 0, 0, 22, 10, 124
"/Users/mac/Workspaces/Code/foa/frontend/src/views/HourSelect/HourSelect.js", "JavaScript", 43, 0, 0, 0, 0, 0, 9, 52
"/Users/mac/Workspaces/Code/foa/frontend/src/views/HourSelect/HourSelect.scss", "SCSS", 0, 38, 0, 0, 0, 3, 7, 48
"/Users/mac/Workspaces/Code/foa/frontend/src/views/HourSelect/index.js", "JavaScript", 2, 0, 0, 0, 0, 0, 2, 4
"/Users/mac/Workspaces/Code/foa/frontend/src/views/app/MenuCreate/MenuCreate.js", "JavaScript", 214, 0, 0, 0, 0, 18, 23, 255
"/Users/mac/Workspaces/Code/foa/frontend/src/views/app/MenuCreate/MenuCreate.scss", "SCSS", 0, 2, 0, 0, 0, 0, 1, 3
"/Users/mac/Workspaces/Code/foa/frontend/src/views/app/MenuCreate/index.js", "JavaScript", 2, 0, 0, 0, 0, 0, 2, 4
"/Users/mac/Workspaces/Code/foa/frontend/src/views/app/MenuGroupCreate/MenuGroupCreate.js", "JavaScript", 96, 0, 0, 0, 0, 1, 9, 106
"/Users/mac/Workspaces/Code/foa/frontend/src/views/app/MenuGroupCreate/MenuGroupCreate.scss", "SCSS", 0, 2, 0, 0, 0, 0, 1, 3
"/Users/mac/Workspaces/Code/foa/frontend/src/views/app/MenuGroupCreate/index.js", "JavaScript", 2, 0, 0, 0, 0, 0, 2, 4
"/Users/mac/Workspaces/Code/foa/frontend/src/views/app/MenuGroupDetail/MenuGroupDetail.jsx", "JavaScript React", 0, 0, 97, 0, 0, 1, 17, 115
"/Users/mac/Workspaces/Code/foa/frontend/src/views/app/MenuGroupDetail/MenuGroupDetail.scss", "SCSS", 0, 37, 0, 0, 0, 2, 9, 48
"/Users/mac/Workspaces/Code/foa/frontend/src/views/app/MenuGroupDetail/index.js", "JavaScript", 2, 0, 0, 0, 0, 0, 2, 4
"/Users/mac/Workspaces/Code/foa/frontend/src/views/app/MenuGroupEdit/MenuGroupEdit.jsx", "JavaScript React", 0, 0, 218, 0, 0, 3, 27, 248
"/Users/mac/Workspaces/Code/foa/frontend/src/views/app/MenuGroupEdit/MenuGroupEdit.scss", "SCSS", 0, 37, 0, 0, 0, 2, 9, 48
"/Users/mac/Workspaces/Code/foa/frontend/src/views/app/MenuGroupEdit/index.js", "JavaScript", 2, 0, 0, 0, 0, 0, 2, 4
"/Users/mac/Workspaces/Code/foa/frontend/src/views/app/MenuGroupList/DataListView.js", "JavaScript", 75, 0, 0, 0, 0, 6, 8, 89
"/Users/mac/Workspaces/Code/foa/frontend/src/views/app/MenuGroupList/MenuGroupList.js", "JavaScript", 177, 0, 0, 0, 0, 3, 29, 209
"/Users/mac/Workspaces/Code/foa/frontend/src/views/app/MenuGroupList/MenuGroupList.scss", "SCSS", 0, 2, 0, 0, 0, 0, 1, 3
"/Users/mac/Workspaces/Code/foa/frontend/src/views/app/MenuGroupList/data-list.js", "JavaScript", 356, 0, 0, 0, 0, 4, 28, 388
"/Users/mac/Workspaces/Code/foa/frontend/src/views/app/MenuGroupList/index.js", "JavaScript", 2, 0, 0, 0, 0, 0, 2, 4
"/Users/mac/Workspaces/Code/foa/frontend/src/views/app/MenuInfo/MenuInfo.js", "JavaScript", 402, 0, 0, 0, 0, 42, 51, 495
"/Users/mac/Workspaces/Code/foa/frontend/src/views/app/MenuInfo/MenuInfo.scss", "SCSS", 0, 7, 0, 0, 0, 1, 1, 9
"/Users/mac/Workspaces/Code/foa/frontend/src/views/app/MenuInfo/data-list.js", "JavaScript", 364, 0, 0, 0, 0, 13, 32, 409
"/Users/mac/Workspaces/Code/foa/frontend/src/views/app/MenuInfo/index.js", "JavaScript", 2, 0, 0, 0, 0, 0, 2, 4
"/Users/mac/Workspaces/Code/foa/frontend/src/views/app/MenuItem/MenuItem.js", "JavaScript", 49, 0, 0, 0, 0, 0, 6, 55
"/Users/mac/Workspaces/Code/foa/frontend/src/views/app/MenuItem/MenuItem.scss", "SCSS", 0, 5, 0, 0, 0, 1, 1, 7
"/Users/mac/Workspaces/Code/foa/frontend/src/views/app/MenuItem/index.js", "JavaScript", 2, 0, 0, 0, 0, 0, 2, 4
"/Users/mac/Workspaces/Code/foa/frontend/src/views/app/MenuItemCreate/MenuItemCreate.js", "JavaScript", 282, 0, 0, 0, 0, 45, 32, 359
"/Users/mac/Workspaces/Code/foa/frontend/src/views/app/MenuItemCreate/MenuItemCreate.scss", "SCSS", 0, 7, 0, 0, 0, 0, 1, 8
"/Users/mac/Workspaces/Code/foa/frontend/src/views/app/MenuItemCreate/index.js", "JavaScript", 2, 0, 0, 0, 0, 0, 2, 4
"/Users/mac/Workspaces/Code/foa/frontend/src/views/app/MenuItemDetail/MenuItemDetail.jsx", "JavaScript React", 0, 0, 114, 0, 0, 2, 17, 133
"/Users/mac/Workspaces/Code/foa/frontend/src/views/app/MenuItemDetail/MenuItemDetail.scss", "SCSS", 0, 37, 0, 0, 0, 2, 9, 48
"/Users/mac/Workspaces/Code/foa/frontend/src/views/app/MenuItemDetail/index.js", "JavaScript", 2, 0, 0, 0, 0, 0, 2, 4
"/Users/mac/Workspaces/Code/foa/frontend/src/views/app/MenuItemEdit/MenuItemEdit.jsx", "JavaScript React", 0, 0, 310, 0, 0, 8, 40, 358
"/Users/mac/Workspaces/Code/foa/frontend/src/views/app/MenuItemEdit/MenuItemEdit.scss", "SCSS", 0, 37, 0, 0, 0, 2, 9, 48
"/Users/mac/Workspaces/Code/foa/frontend/src/views/app/MenuItemEdit/index.js", "JavaScript", 2, 0, 0, 0, 0, 0, 2, 4
"/Users/mac/Workspaces/Code/foa/frontend/src/views/app/NewOrderDetail/NewOrderDetail.jsx", "JavaScript React", 0, 0, 6, 0, 0, 0, 4, 10
"/Users/mac/Workspaces/Code/foa/frontend/src/views/app/NewOrderDetail/NewOrderDetail.scss", "SCSS", 0, 2, 0, 0, 0, 0, 1, 3
"/Users/mac/Workspaces/Code/foa/frontend/src/views/app/NewOrderDetail/index.js", "JavaScript", 2, 0, 0, 0, 0, 0, 2, 4
"/Users/mac/Workspaces/Code/foa/frontend/src/views/app/OrderDetail/OrderDetail.jsx", "JavaScript React", 0, 0, 147, 0, 0, 1, 18, 166
"/Users/mac/Workspaces/Code/foa/frontend/src/views/app/OrderDetail/OrderDetail.scss", "SCSS", 0, 9, 0, 0, 0, 0, 2, 11
"/Users/mac/Workspaces/Code/foa/frontend/src/views/app/OrderDetail/index.js", "JavaScript", 2, 0, 0, 0, 0, 0, 2, 4
"/Users/mac/Workspaces/Code/foa/frontend/src/views/app/OrderList/DataListView.js", "JavaScript", 96, 0, 0, 0, 0, 2, 10, 108
"/Users/mac/Workspaces/Code/foa/frontend/src/views/app/OrderList/ImageListView.js", "JavaScript", 69, 0, 0, 0, 0, 1, 3, 73
"/Users/mac/Workspaces/Code/foa/frontend/src/views/app/OrderList/OrderList.jsx", "JavaScript React", 0, 0, 198, 0, 0, 11, 30, 239
"/Users/mac/Workspaces/Code/foa/frontend/src/views/app/OrderList/OrderList.scss", "SCSS", 0, 2, 0, 0, 0, 0, 1, 3
"/Users/mac/Workspaces/Code/foa/frontend/src/views/app/OrderList/ThumbListView.js", "JavaScript", 75, 0, 0, 0, 0, 1, 4, 80
"/Users/mac/Workspaces/Code/foa/frontend/src/views/app/OrderList/data-list.js", "JavaScript", 346, 0, 0, 0, 0, 50, 32, 428
"/Users/mac/Workspaces/Code/foa/frontend/src/views/app/OrderList/index.js", "JavaScript", 2, 0, 0, 0, 0, 0, 2, 4
"/Users/mac/Workspaces/Code/foa/frontend/src/views/app/SelectTopping/SelectTopping.js", "JavaScript", 310, 0, 0, 0, 0, 21, 43, 374
"/Users/mac/Workspaces/Code/foa/frontend/src/views/app/SelectTopping/SelectTopping.scss", "SCSS", 0, 2, 0, 0, 0, 0, 1, 3
"/Users/mac/Workspaces/Code/foa/frontend/src/views/app/SelectTopping/index.js", "JavaScript", 2, 0, 0, 0, 0, 0, 2, 4
"/Users/mac/Workspaces/Code/foa/frontend/src/views/app/SelectToppingCard/SelectToppingCard.jsx", "JavaScript React", 0, 0, 84, 0, 0, 14, 11, 109
"/Users/mac/Workspaces/Code/foa/frontend/src/views/app/SelectToppingCard/SelectToppingCard.scss", "SCSS", 0, 16, 0, 0, 0, 0, 4, 20
"/Users/mac/Workspaces/Code/foa/frontend/src/views/app/SelectToppingCard/index.js", "JavaScript", 2, 0, 0, 0, 0, 0, 2, 4
"/Users/mac/Workspaces/Code/foa/frontend/src/views/app/StaffDetail/StaffDetail.jsx", "JavaScript React", 0, 0, 81, 0, 0, 1, 18, 100
"/Users/mac/Workspaces/Code/foa/frontend/src/views/app/StaffDetail/StaffDetail.scss", "SCSS", 0, 40, 0, 0, 0, 3, 10, 53
"/Users/mac/Workspaces/Code/foa/frontend/src/views/app/StaffDetail/index.js", "JavaScript", 2, 0, 0, 0, 0, 0, 2, 4
"/Users/mac/Workspaces/Code/foa/frontend/src/views/app/StaffEdit/StaffEdit.jsx", "JavaScript React", 0, 0, 257, 0, 0, 23, 40, 320
"/Users/mac/Workspaces/Code/foa/frontend/src/views/app/StaffEdit/StaffEdit.scss", "SCSS", 0, 37, 0, 0, 0, 2, 9, 48
"/Users/mac/Workspaces/Code/foa/frontend/src/views/app/StaffEdit/index.js", "JavaScript", 2, 0, 0, 0, 0, 0, 2, 4
"/Users/mac/Workspaces/Code/foa/frontend/src/views/app/StaffList/DataListView.js", "JavaScript", 87, 0, 0, 0, 0, 10, 6, 103
"/Users/mac/Workspaces/Code/foa/frontend/src/views/app/StaffList/ImageListView.js", "JavaScript", 69, 0, 0, 0, 0, 1, 3, 73
"/Users/mac/Workspaces/Code/foa/frontend/src/views/app/StaffList/StaffList.jsx", "JavaScript React", 0, 0, 138, 0, 0, 2, 21, 161
"/Users/mac/Workspaces/Code/foa/frontend/src/views/app/StaffList/StaffList.scss", "SCSS", 0, 2, 0, 0, 0, 0, 1, 3
"/Users/mac/Workspaces/Code/foa/frontend/src/views/app/StaffList/ThumbListView.js", "JavaScript", 75, 0, 0, 0, 0, 1, 4, 80
"/Users/mac/Workspaces/Code/foa/frontend/src/views/app/StaffList/data-list.js", "JavaScript", 319, 0, 0, 0, 0, 18, 29, 366
"/Users/mac/Workspaces/Code/foa/frontend/src/views/app/StaffList/index.js", "JavaScript", 2, 0, 0, 0, 0, 0, 2, 4
"/Users/mac/Workspaces/Code/foa/frontend/src/views/app/ToppingGroupCreate/ToppingGroupCreate.js", "JavaScript", 153, 0, 0, 0, 0, 10, 16, 179
"/Users/mac/Workspaces/Code/foa/frontend/src/views/app/ToppingGroupCreate/ToppingGroupCreate.scss", "SCSS", 0, 2, 0, 0, 0, 0, 1, 3
"/Users/mac/Workspaces/Code/foa/frontend/src/views/app/ToppingGroupCreate/index.js", "JavaScript", 2, 0, 0, 0, 0, 0, 2, 4
"/Users/mac/Workspaces/Code/foa/frontend/src/views/app/ToppingGroupDetail/ToppingGroupDetail.jsx", "JavaScript React", 0, 0, 111, 0, 0, 1, 17, 129
"/Users/mac/Workspaces/Code/foa/frontend/src/views/app/ToppingGroupDetail/ToppingGroupDetail.scss", "SCSS", 0, 37, 0, 0, 0, 2, 9, 48
"/Users/mac/Workspaces/Code/foa/frontend/src/views/app/ToppingGroupDetail/index.js", "JavaScript", 2, 0, 0, 0, 0, 0, 2, 4
"/Users/mac/Workspaces/Code/foa/frontend/src/views/app/ToppingGroupEdit/ToppingGroupEdit.jsx", "JavaScript React", 0, 0, 227, 0, 0, 3, 27, 257
"/Users/mac/Workspaces/Code/foa/frontend/src/views/app/ToppingGroupEdit/ToppingGroupEdit.scss", "SCSS", 0, 37, 0, 0, 0, 2, 9, 48
"/Users/mac/Workspaces/Code/foa/frontend/src/views/app/ToppingGroupEdit/index.js", "JavaScript", 2, 0, 0, 0, 0, 0, 2, 4
"/Users/mac/Workspaces/Code/foa/frontend/src/views/app/ToppingGroupList/DataListView.js", "JavaScript", 75, 0, 0, 0, 0, 2, 8, 85
"/Users/mac/Workspaces/Code/foa/frontend/src/views/app/ToppingGroupList/ToppingGroupList.js", "JavaScript", 262, 0, 0, 0, 0, 2, 34, 298
"/Users/mac/Workspaces/Code/foa/frontend/src/views/app/ToppingGroupList/ToppingGroupList.scss", "SCSS", 0, 2, 0, 0, 0, 0, 1, 3
"/Users/mac/Workspaces/Code/foa/frontend/src/views/app/ToppingGroupList/data-list.js", "JavaScript", 357, 0, 0, 0, 0, 5, 28, 390
"/Users/mac/Workspaces/Code/foa/frontend/src/views/app/ToppingGroupList/index.js", "JavaScript", 2, 0, 0, 0, 0, 0, 2, 4
"/Users/mac/Workspaces/Code/foa/frontend/src/views/app/ToppingItemCreate/ToppingItemCreate.js", "JavaScript", 280, 0, 0, 0, 0, 50, 31, 361
"/Users/mac/Workspaces/Code/foa/frontend/src/views/app/ToppingItemCreate/ToppingItemCreate.scss", "SCSS", 0, 2, 0, 0, 0, 0, 1, 3
"/Users/mac/Workspaces/Code/foa/frontend/src/views/app/ToppingItemCreate/index.js", "JavaScript", 2, 0, 0, 0, 0, 0, 2, 4
"/Users/mac/Workspaces/Code/foa/frontend/src/views/app/ToppingItemDetail/ToppingItemDetail.jsx", "JavaScript React", 0, 0, 111, 0, 0, 1, 20, 132
"/Users/mac/Workspaces/Code/foa/frontend/src/views/app/ToppingItemDetail/ToppingItemDetail.scss", "SCSS", 0, 37, 0, 0, 0, 2, 9, 48
"/Users/mac/Workspaces/Code/foa/frontend/src/views/app/ToppingItemDetail/index.js", "JavaScript", 2, 0, 0, 0, 0, 0, 2, 4
"/Users/mac/Workspaces/Code/foa/frontend/src/views/app/ToppingItemEdit/ToppingItemEdit.jsx", "JavaScript React", 0, 0, 319, 0, 0, 21, 40, 380
"/Users/mac/Workspaces/Code/foa/frontend/src/views/app/ToppingItemEdit/ToppingItemEdit.scss", "SCSS", 0, 37, 0, 0, 0, 2, 9, 48
"/Users/mac/Workspaces/Code/foa/frontend/src/views/app/ToppingItemEdit/index.js", "JavaScript", 2, 0, 0, 0, 0, 0, 2, 4
"/Users/mac/Workspaces/Code/foa/frontend/src/views/app/ToppingList/ToppingList.js", "JavaScript", 345, 0, 0, 0, 0, 5, 41, 391
"/Users/mac/Workspaces/Code/foa/frontend/src/views/app/ToppingList/ToppingList.scss", "SCSS", 0, 2, 0, 0, 0, 0, 1, 3
"/Users/mac/Workspaces/Code/foa/frontend/src/views/app/ToppingList/data-list.js", "JavaScript", 357, 0, 0, 0, 0, 23, 30, 410
"/Users/mac/Workspaces/Code/foa/frontend/src/views/app/ToppingList/index.js", "JavaScript", 2, 0, 0, 0, 0, 0, 2, 4
"/Users/mac/Workspaces/Code/foa/frontend/src/views/app/analytics/analytics.js", "JavaScript", 440, 0, 0, 0, 0, 71, 66, 577
"/Users/mac/Workspaces/Code/foa/frontend/src/views/app/analytics/index.js", "JavaScript", 19, 0, 0, 0, 0, 0, 2, 21
"/Users/mac/Workspaces/Code/foa/frontend/src/views/app/blank-page.js", "JavaScript", 24, 0, 0, 0, 0, 0, 2, 26
"/Users/mac/Workspaces/Code/foa/frontend/src/views/app/cashier/cashier.js", "JavaScript", 25, 0, 0, 0, 0, 0, 2, 27
"/Users/mac/Workspaces/Code/foa/frontend/src/views/app/cashier/index.js", "JavaScript", 18, 0, 0, 0, 0, 0, 3, 21
"/Users/mac/Workspaces/Code/foa/frontend/src/views/app/dishes/data-list.js", "JavaScript", 319, 0, 0, 0, 0, 37, 30, 386
"/Users/mac/Workspaces/Code/foa/frontend/src/views/app/dishes/dishes.js", "JavaScript", 172, 0, 0, 0, 0, 10, 22, 204
"/Users/mac/Workspaces/Code/foa/frontend/src/views/app/dishes/index.js", "JavaScript", 52, 0, 0, 0, 0, 1, 13, 66
"/Users/mac/Workspaces/Code/foa/frontend/src/views/app/dishes/mockData.json", "JSON", 0, 0, 0, 129, 0, 0, 0, 129
"/Users/mac/Workspaces/Code/foa/frontend/src/views/app/dishes/utils.js", "JavaScript", 6, 0, 0, 0, 0, 0, 2, 8
"/Users/mac/Workspaces/Code/foa/frontend/src/views/app/edit/edit.js", "JavaScript", 375, 0, 0, 0, 0, 90, 37, 502
"/Users/mac/Workspaces/Code/foa/frontend/src/views/app/edit/edit.scss", "SCSS", 0, 25, 0, 0, 0, 1, 5, 31
"/Users/mac/Workspaces/Code/foa/frontend/src/views/app/edit/index.js", "JavaScript", 18, 0, 0, 0, 0, 0, 3, 21
"/Users/mac/Workspaces/Code/foa/frontend/src/views/app/home/home.js", "JavaScript", 249, 0, 0, 0, 0, 11, 24, 284
"/Users/mac/Workspaces/Code/foa/frontend/src/views/app/home/home.scss", "SCSS", 0, 62, 0, 0, 0, 8, 13, 83
"/Users/mac/Workspaces/Code/foa/frontend/src/views/app/home/index.js", "JavaScript", 24, 0, 0, 0, 0, 0, 3, 27
"/Users/mac/Workspaces/Code/foa/frontend/src/views/app/index.js", "JavaScript", 116, 0, 0, 0, 0, 14, 22, 152
"/Users/mac/Workspaces/Code/foa/frontend/src/views/app/map/index.js", "JavaScript", 15, 0, 0, 0, 0, 0, 2, 17
"/Users/mac/Workspaces/Code/foa/frontend/src/views/app/map/map.js", "JavaScript", 80, 0, 0, 0, 0, 18, 11, 109
"/Users/mac/Workspaces/Code/foa/frontend/src/views/app/map/map.scss", "SCSS", 0, 2, 0, 0, 0, 0, 1, 3
"/Users/mac/Workspaces/Code/foa/frontend/src/views/app/menuGroup/index.js", "JavaScript", 43, 0, 0, 0, 0, 45, 6, 94
"/Users/mac/Workspaces/Code/foa/frontend/src/views/app/newOrder/index.js", "JavaScript", 19, 0, 0, 0, 0, 0, 4, 23
"/Users/mac/Workspaces/Code/foa/frontend/src/views/app/orders/index.js", "JavaScript", 27, 0, 0, 0, 0, 0, 5, 32
"/Users/mac/Workspaces/Code/foa/frontend/src/views/app/paypal/index.js", "JavaScript", 18, 0, 0, 0, 0, 0, 2, 20
"/Users/mac/Workspaces/Code/foa/frontend/src/views/app/paypal/paypal.js", "JavaScript", 173, 0, 0, 0, 0, 12, 18, 203
"/Users/mac/Workspaces/Code/foa/frontend/src/views/app/paypal/paypal.scss", "SCSS", 0, 2, 0, 0, 0, 0, 1, 3
"/Users/mac/Workspaces/Code/foa/frontend/src/views/app/second-menu/index.js", "JavaScript", 18, 0, 0, 0, 0, 0, 2, 20
"/Users/mac/Workspaces/Code/foa/frontend/src/views/app/second-menu/second-menu.scss", "SCSS", 0, 0, 0, 0, 0, 0, 1, 1
"/Users/mac/Workspaces/Code/foa/frontend/src/views/app/second-menu/second.js", "JavaScript", 24, 0, 0, 0, 0, 0, 2, 26
"/Users/mac/Workspaces/Code/foa/frontend/src/views/app/staffs/create.js", "JavaScript", 11, 0, 0, 0, 0, 1, 3, 15
"/Users/mac/Workspaces/Code/foa/frontend/src/views/app/staffs/create.scss", "SCSS", 0, 2, 0, 0, 0, 0, 1, 3
"/Users/mac/Workspaces/Code/foa/frontend/src/views/app/staffs/createStaff.js", "JavaScript", 194, 0, 0, 0, 0, 7, 26, 227
"/Users/mac/Workspaces/Code/foa/frontend/src/views/app/staffs/index.js", "JavaScript", 42, 0, 0, 0, 0, 0, 6, 48
"/Users/mac/Workspaces/Code/foa/frontend/src/views/app/toppingGroup/index.js", "JavaScript", 43, 0, 0, 0, 0, 45, 6, 94
"/Users/mac/Workspaces/Code/foa/frontend/src/views/app/toppings/data-list.js", "JavaScript", 296, 0, 0, 0, 0, 74, 31, 401
"/Users/mac/Workspaces/Code/foa/frontend/src/views/app/toppings/index.js", "JavaScript", 56, 0, 0, 0, 0, 22, 6, 84
"/Users/mac/Workspaces/Code/foa/frontend/src/views/app/toppings/mockData.json", "JSON", 0, 0, 0, 129, 0, 0, 0, 129
"/Users/mac/Workspaces/Code/foa/frontend/src/views/app/toppings/topppings.js", "JavaScript", 127, 0, 0, 0, 0, 25, 17, 169
"/Users/mac/Workspaces/Code/foa/frontend/src/views/app/toppings/utils.js", "JavaScript", 3, 0, 0, 0, 0, 0, 1, 4
"/Users/mac/Workspaces/Code/foa/frontend/src/views/error.js", "JavaScript", 60, 0, 0, 0, 0, 0, 2, 62
"/Users/mac/Workspaces/Code/foa/frontend/src/views/index.js", "JavaScript", 13, 0, 0, 0, 0, 0, 4, 17
"/Users/mac/Workspaces/Code/foa/frontend/src/views/merchant/forgot-password.js", "JavaScript", 150, 0, 0, 0, 0, 3, 13, 166
"/Users/mac/Workspaces/Code/foa/frontend/src/views/merchant/index.js", "JavaScript", 44, 0, 0, 0, 0, 1, 5, 50
"/Users/mac/Workspaces/Code/foa/frontend/src/views/merchant/login.js", "JavaScript", 163, 0, 0, 0, 0, 16, 14, 193
"/Users/mac/Workspaces/Code/foa/frontend/src/views/merchant/register.js", "JavaScript", 300, 0, 0, 0, 0, 14, 27, 341
"/Users/mac/Workspaces/Code/foa/frontend/src/views/merchant/reset-password.js", "JavaScript", 160, 0, 0, 0, 0, 0, 15, 175
"/Users/mac/Workspaces/Code/foa/frontend/src/views/restaurant/create-restaurant.scss", "SCSS", 0, 29, 0, 0, 0, 44, 13, 86
"/Users/mac/Workspaces/Code/foa/frontend/src/views/restaurant/create.js", "JavaScript", 439, 0, 0, 0, 0, 36, 54, 529
"/Users/mac/Workspaces/Code/foa/frontend/src/views/restaurant/create.scss", "SCSS", 0, 2, 0, 0, 0, 0, 1, 3
"/Users/mac/Workspaces/Code/foa/frontend/src/views/restaurant/index.js", "JavaScript", 30, 0, 0, 0, 0, 7, 4, 41
"/Users/mac/Workspaces/Code/foa/frontend/src/views/restaurant/mockData.js", "JavaScript", 17, 0, 0, 0, 0, 0, 1, 18
"/Users/mac/Workspaces/Code/foa/frontend/src/views/restaurant/restaurant.scss", "SCSS", 0, 87, 0, 0, 0, 5, 15, 107
"/Users/mac/Workspaces/Code/foa/frontend/src/views/restaurant/select.js", "JavaScript", 352, 0, 0, 0, 0, 4, 36, 392
"/Users/mac/Workspaces/Code/foa/frontend/src/views/restaurant/select.scss", "SCSS", 0, 3, 0, 0, 0, 0, 1, 4
"/Users/mac/Workspaces/Code/foa/frontend/src/views/utils/index.js", "JavaScript", 3, 0, 0, 0, 0, 0, 1, 4
"Total", "-", 22789, 8670, 2469, 258, 1357, 2062, 4738, 42343